77777777777777777777
77777777777777777777
77777711111111777777
77777777777777777777
77772222222222227777
77775757777776767777
77775757777776767777
77791711181111718777
77757777767777776777
77242722232222723277
77577777777777777577
77577777777777777577
79111718111111711187
75777776777777777767
24222223222222222232
